,gender,race/ethnicity,parental level of education,lunch,test preparation course,math score,reading score,writing score,total score
0,female,group B,4,standard,0,72,72,74,218
1,female,group C,2,standard,1,69,90,88,247
2,female,group B,5,standard,0,90,95,93,278
3,male,group A,3,free/reduced,0,47,57,44,148
4,male,group C,2,standard,0,76,78,75,229
5,female,group B,3,standard,0,71,83,78,232
6,female,group B,2,standard,1,88,95,92,275
7,male,group B,2,free/reduced,0,40,43,39,122
8,male,group D,1,free/reduced,1,64,64,67,195
9,female,group B,1,free/reduced,0,38,60,50,148
10,male,group C,3,standard,0,58,54,52,164
11,male,group D,3,standard,0,40,52,43,135
12,female,group B,1,standard,0,65,81,73,219
13,male,group A,2,standard,1,78,72,70,220
14,female,group A,5,standard,0,50,53,58,161
15,female,group C,0,standard,0,69,75,78,222
16,male,group C,1,standard,0,88,89,86,263
18,male,group C,5,free/reduced,1,46,42,46,134
19,female,group C,3,free/reduced,0,54,58,61,173
20,male,group D,1,standard,0,66,69,63,198
21,female,group B,2,free/reduced,1,65,75,70,210
22,male,group D,2,standard,0,44,54,53,151
23,female,group C,0,standard,0,69,73,73,215
24,male,group D,4,free/reduced,1,74,71,80,225
25,male,group A,5,free/reduced,0,73,74,72,219
26,male,group B,2,standard,0,69,54,55,178
27,female,group C,4,standard,0,67,69,75,211
28,male,group C,1,standard,0,70,70,65,205
29,female,group D,5,standard,0,62,70,75,207
30,female,group D,2,standard,0,69,74,74,217
31,female,group B,2,standard,0,63,65,61,189
32,female,group E,5,free/reduced,0,56,72,65,193
33,male,group D,2,standard,0,40,42,38,120
34,male,group E,2,standard,0,97,87,82,266
35,male,group E,3,standard,1,81,81,79,241
36,female,group D,3,standard,0,74,81,83,238
37,female,group D,0,free/reduced,0,50,64,59,173
38,female,group D,3,free/reduced,1,75,90,88,253
39,male,group B,3,free/reduced,0,57,56,57,170
40,male,group C,3,free/reduced,0,55,61,54,170
41,female,group C,3,standard,0,58,73,68,199
42,female,group B,3,standard,0,53,58,65,176
43,male,group B,2,free/reduced,1,59,65,66,190
44,female,group E,3,free/reduced,0,50,56,54,160
45,male,group B,3,standard,0,65,54,57,176
46,female,group A,3,standard,1,55,65,62,182
47,female,group C,1,standard,0,66,71,76,213
48,female,group D,3,free/reduced,1,57,74,76,207
49,male,group C,1,standard,1,82,84,82,248
50,male,group E,2,standard,0,53,55,48,156
51,male,group E,3,free/reduced,1,77,69,68,214
52,male,group C,2,standard,0,53,44,42,139
53,male,group D,1,standard,0,88,78,75,241
54,female,group C,0,free/reduced,1,71,84,87,242
55,female,group C,1,free/reduced,0,33,41,43,117
56,female,group E,3,standard,1,82,85,86,253
57,male,group D,3,standard,0,52,55,49,156
58,male,group D,2,standard,1,58,59,58,175
60,male,group E,4,free/reduced,1,79,74,72,225
61,male,group A,0,free/reduced,0,39,39,34,112
62,male,group A,3,free/reduced,0,62,61,55,178
63,female,group C,3,standard,0,69,80,71,220
64,female,group D,0,standard,0,59,58,59,176
65,male,group B,0,standard,0,67,64,61,192
66,male,group D,0,free/reduced,0,45,37,37,119
67,female,group C,2,standard,0,60,72,74,206
68,male,group B,3,free/reduced,0,61,58,56,175
69,female,group C,3,standard,0,39,64,57,160
70,female,group D,2,free/reduced,1,58,63,73,194
71,male,group D,2,standard,1,63,55,63,181
72,female,group A,3,free/reduced,0,41,51,48,140
73,male,group C,0,free/reduced,0,61,57,56,174
74,male,group C,0,standard,0,49,49,41,139
75,male,group B,3,free/reduced,0,44,41,38,123
77,male,group A,4,standard,1,80,78,81,239
78,female,group D,0,standard,1,61,74,72,207
79,female,group E,5,standard,0,62,68,68,198
80,female,group B,3,standard,0,47,49,50,146
81,male,group B,1,free/reduced,0,49,45,45,139
82,male,group A,2,free/reduced,1,50,47,54,151
83,male,group E,3,standard,0,72,64,63,199
84,male,group D,1,free/reduced,0,42,39,34,115
85,female,group C,2,standard,0,73,80,82,235
86,female,group C,2,free/reduced,0,76,83,88,247
87,female,group D,3,standard,0,71,71,74,216
88,female,group A,2,standard,0,58,70,67,195
89,female,group D,0,standard,0,73,86,82,241
90,female,group C,4,standard,0,65,72,74,211
91,male,group C,1,free/reduced,0,27,34,36,97
92,male,group C,1,standard,0,71,79,71,221
93,male,group C,3,free/reduced,1,43,45,50,138
94,female,group B,2,standard,0,79,86,92,257
95,male,group C,3,free/reduced,1,78,81,82,241
96,male,group B,0,standard,1,65,66,62,193
97,female,group E,2,standard,1,63,72,70,205
98,female,group D,2,free/reduced,0,58,67,62,187
99,female,group D,4,standard,0,65,67,62,194
100,male,group B,2,standard,0,79,67,67,213
101,male,group D,4,standard,1,68,74,74,216
102,female,group D,3,standard,0,85,91,89,265
103,male,group B,1,standard,1,60,44,47,151
104,male,group C,2,standard,1,98,86,90,274
105,female,group C,2,standard,0,58,67,72,197
106,female,group D,5,standard,0,87,100,100,287
107,male,group E,3,standard,1,66,63,64,193
108,female,group B,3,free/reduced,0,52,76,70,198
109,female,group B,0,standard,0,70,64,72,206
110,female,group D,3,free/reduced,1,77,89,98,264
111,male,group C,1,standard,0,62,55,49,166
112,male,group A,3,standard,0,54,53,47,154
113,female,group D,2,standard,0,51,58,54,163
114,female,group E,4,standard,1,99,100,100,299
115,male,group C,1,standard,0,84,77,74,235
116,female,group B,4,free/reduced,0,75,85,82,242
117,female,group D,4,standard,0,78,82,79,239
118,female,group D,0,standard,0,51,63,61,175
119,female,group C,2,standard,0,55,69,65,189
120,female,group C,4,standard,1,79,92,89,260
121,male,group B,3,standard,1,91,89,92,272
122,female,group C,2,standard,1,88,93,93,274
123,male,group D,1,free/reduced,0,63,57,56,176
124,male,group E,2,standard,0,83,80,73,236
125,female,group B,1,standard,0,87,95,86,268
126,male,group B,0,standard,0,72,68,67,207
127,male,group D,2,standard,1,65,77,74,216
128,male,group D,5,standard,0,82,82,74,238
129,female,group A,4,standard,0,51,49,51,151
130,male,group D,5,standard,0,89,84,82,255
131,male,group C,0,free/reduced,1,53,37,40,130
132,male,group E,2,free/reduced,1,87,74,70,231
133,female,group C,2,standard,1,75,81,84,240
134,male,group D,4,free/reduced,1,74,79,75,228
135,male,group C,4,standard,0,58,55,48,161
136,male,group B,0,standard,1,51,54,41,146
137,male,group E,1,standard,0,70,55,56,181
138,female,group C,3,standard,0,59,66,67,192
139,male,group D,2,standard,1,71,61,69,201
140,female,group D,0,standard,0,76,72,71,219
141,female,group C,2,free/reduced,0,59,62,64,185
142,female,group E,2,free/reduced,1,42,55,54,151
143,male,group A,1,standard,0,57,43,47,147
144,male,group D,2,standard,0,88,73,78,239
145,female,group C,2,free/reduced,0,22,39,33,94
146,male,group B,0,standard,0,88,84,75,247
147,male,group C,3,free/reduced,0,73,68,66,207
148,female,group D,4,standard,1,68,75,81,224
149,male,group E,3,free/reduced,1,100,100,93,293
150,male,group A,0,standard,1,62,67,69,198
151,male,group A,4,standard,0,77,67,68,212
152,female,group B,3,standard,1,59,70,66,195
153,male,group D,4,standard,0,54,49,47,150
154,male,group D,0,standard,0,62,67,61,190
155,female,group C,2,standard,1,70,89,88,247
156,female,group E,1,free/reduced,1,66,74,78,218
157,male,group B,2,free/reduced,0,60,60,60,180
158,female,group B,3,standard,1,61,86,87,234
159,male,group D,3,free/reduced,0,66,62,64,192
160,male,group B,3,free/reduced,1,82,78,74,234
161,female,group E,2,free/reduced,1,75,88,85,248
162,male,group B,5,free/reduced,0,49,53,52,154
163,male,group C,1,standard,0,52,53,49,154
164,female,group E,5,standard,0,81,92,91,264
165,female,group C,4,standard,1,96,100,100,296
166,male,group C,1,free/reduced,1,53,51,51,155
167,female,group B,5,free/reduced,1,58,76,78,212
168,female,group B,1,standard,1,68,83,78,229
169,female,group C,2,free/reduced,1,67,75,70,212
170,male,group A,1,standard,1,72,73,74,219
171,male,group E,0,standard,0,94,88,78,260
172,female,group D,2,standard,0,79,86,81,246
173,female,group C,3,standard,0,63,67,70,200
174,female,group C,4,free/reduced,1,43,51,54,148
175,female,group C,5,standard,1,81,91,87,259
176,female,group B,1,free/reduced,1,46,54,58,158
177,female,group C,3,standard,1,71,77,77,225
178,female,group B,5,free/reduced,1,52,70,62,184
179,female,group D,0,standard,1,97,100,100,297
180,male,group C,5,free/reduced,1,62,68,75,205
181,female,group C,2,free/reduced,0,46,64,66,176
182,female,group E,1,standard,0,50,50,47,147
183,female,group D,3,standard,0,65,69,70,204
184,male,group C,0,free/reduced,1,45,52,49,146
185,male,group C,3,free/reduced,1,65,67,65,197
186,male,group E,1,standard,0,80,76,65,221
187,male,group D,0,standard,1,62,66,68,196
188,male,group B,0,free/reduced,0,48,52,45,145
189,female,group C,4,standard,0,77,88,87,252
190,female,group E,3,standard,0,66,65,69,200
191,male,group D,2,standard,1,76,83,79,238
192,female,group B,0,standard,0,62,64,66,192
193,male,group D,2,standard,1,77,62,62,201
194,female,group C,5,standard,1,69,84,85,238
195,male,group D,3,standard,0,61,55,52,168
196,male,group C,0,free/reduced,1,59,69,65,193
197,male,group E,1,free/reduced,0,55,56,51,162
198,female,group B,2,free/reduced,0,45,53,55,153
199,female,group B,4,free/reduced,0,78,79,76,233
200,female,group C,3,standard,1,67,84,86,237
201,female,group D,2,free/reduced,0,65,81,77,223
202,male,group C,3,standard,0,69,77,69,215
203,female,group B,3,standard,0,57,69,68,194
204,male,group C,2,standard,0,59,41,42,142
205,male,group D,0,standard,1,74,71,78,223
206,male,group E,4,standard,0,82,62,62,206
207,male,group E,1,standard,1,81,80,76,237
208,female,group B,2,free/reduced,0,74,81,76,231
209,female,group B,2,free/reduced,0,58,61,66,185
210,male,group D,0,free/reduced,1,80,79,79,238
211,male,group C,2,free/reduced,0,35,28,27,90
212,female,group C,1,free/reduced,0,42,62,60,164
213,male,group C,3,free/reduced,1,60,51,56,167
214,male,group E,1,standard,1,87,91,81,259
215,male,group B,0,standard,1,84,83,75,242
216,female,group E,3,free/reduced,1,83,86,88,257
217,female,group C,1,free/reduced,0,34,42,39,115
218,male,group B,1,free/reduced,0,66,77,70,213
219,male,group B,0,standard,1,61,56,56,173
220,female,group D,1,standard,1,56,68,74,198
221,male,group B,3,standard,0,87,85,73,245
222,female,group C,0,free/reduced,0,55,65,62,182
223,male,group D,0,standard,0,86,80,75,241
224,female,group B,3,standard,1,52,66,73,191
225,female,group E,5,free/reduced,0,45,56,54,155
226,female,group C,2,standard,0,72,72,71,215
227,male,group D,1,standard,0,57,50,54,161
228,male,group A,0,free/reduced,0,68,72,64,204
229,female,group C,2,standard,1,88,95,94,277
230,male,group D,2,standard,0,76,64,66,206
231,male,group C,3,standard,0,46,43,42,131
232,female,group B,4,standard,0,67,86,83,236
233,male,group E,0,standard,0,92,87,78,257
234,male,group C,4,standard,1,83,82,84,249
235,male,group D,3,standard,0,80,75,77,232
236,male,group D,4,free/reduced,0,63,66,67,196
237,female,group D,0,standard,1,64,60,74,198
238,male,group B,2,standard,0,54,52,51,157
239,male,group C,3,standard,0,84,80,80,244
240,male,group D,1,free/reduced,1,73,68,66,207
241,female,group E,4,standard,0,80,83,83,246
242,female,group D,1,standard,0,56,52,55,163
243,male,group E,2,standard,0,59,51,43,153
244,male,group D,0,standard,0,75,74,69,218
245,male,group C,3,standard,0,85,76,71,232
246,male,group E,3,standard,0,89,76,74,239
247,female,group B,1,standard,1,58,70,68,196
248,female,group B,1,standard,0,65,64,62,191
249,male,group C,1,standard,0,68,60,53,181
250,male,group A,0,standard,1,47,49,49,145
251,female,group D,2,free/reduced,0,71,83,83,237
252,female,group B,0,standard,1,60,70,70,200
253,male,group D,5,standard,0,80,80,72,232
254,male,group D,1,standard,0,54,52,52,158
255,female,group E,2,standard,0,62,73,70,205
256,female,group C,3,free/reduced,0,64,73,68,205
257,male,group C,3,standard,1,78,77,77,232
258,female,group B,2,standard,0,70,75,78,223
259,female,group C,5,free/reduced,1,65,81,81,227
260,female,group C,0,free/reduced,1,64,79,77,220
261,male,group C,2,standard,1,79,79,78,236
262,female,group C,0,free/reduced,0,44,50,51,145
263,female,group E,1,standard,0,99,93,90,282
264,male,group D,1,standard,0,76,73,68,217
265,male,group D,0,free/reduced,0,59,42,41,142
266,female,group C,4,standard,0,63,75,81,219
267,female,group D,1,standard,0,69,72,77,218
268,female,group D,3,standard,1,88,92,95,275
269,female,group E,2,free/reduced,0,71,76,70,217
270,male,group C,4,standard,0,69,63,61,193
271,male,group C,2,standard,0,58,49,42,149
272,female,group D,3,free/reduced,0,47,53,58,158
273,female,group D,2,standard,0,65,70,71,206
274,male,group B,2,standard,1,88,85,76,249
275,male,group C,4,standard,0,83,78,73,234
276,female,group C,0,standard,1,85,92,93,270
277,female,group E,1,standard,1,59,63,75,197
278,female,group C,0,free/reduced,0,65,86,80,231
279,male,group B,4,free/reduced,0,73,56,57,186
280,male,group D,1,standard,0,53,52,42,147
281,male,group D,1,standard,0,45,48,46,139
282,female,group D,4,free/reduced,0,73,79,84,236
283,female,group D,2,free/reduced,1,70,78,78,226
284,female,group B,0,standard,0,37,46,46,129
285,male,group B,3,standard,1,81,82,82,245
286,male,group E,3,standard,1,97,82,88,267
287,female,group B,0,standard,0,67,89,82,238
288,male,group B,4,free/reduced,0,88,75,76,239
289,male,group E,0,standard,1,77,76,77,230
290,male,group C,3,standard,0,76,70,68,214
291,male,group D,0,standard,0,86,73,70,229
292,male,group C,0,standard,1,63,60,57,180
293,female,group E,4,standard,0,65,73,75,213
294,male,group D,1,free/reduced,1,78,77,80,235
295,male,group B,3,free/reduced,0,67,62,60,189
296,male,group A,0,standard,1,46,41,43,130
297,male,group E,3,standard,1,71,74,68,213
298,male,group C,1,free/reduced,1,40,46,50,136
299,male,group D,3,free/reduced,0,90,87,75,252
300,male,group A,2,free/reduced,1,81,78,81,240
301,male,group D,0,free/reduced,0,56,54,52,162
302,female,group C,3,standard,1,67,84,81,232
303,male,group B,3,standard,0,80,76,64,220
304,female,group C,3,standard,1,74,75,83,232
305,male,group A,2,standard,0,69,67,69,205
306,male,group E,2,standard,1,99,87,81,267
307,male,group C,0,standard,0,51,52,44,147
308,female,group B,3,free/reduced,0,53,71,67,191
309,female,group D,1,free/reduced,0,49,57,52,158
310,female,group B,3,standard,0,73,76,80,229
311,male,group B,4,standard,0,66,60,57,183
312,male,group D,4,standard,1,67,61,68,196
313,female,group C,3,free/reduced,1,68,67,69,204
314,female,group C,4,standard,1,59,64,75,198
315,male,group C,1,standard,0,71,66,65,202
316,female,group D,5,standard,1,77,82,91,250
317,male,group C,3,standard,0,83,72,78,233
318,male,group B,4,standard,0,63,71,69,203
319,female,group D,3,free/reduced,0,56,65,63,184
320,female,group C,1,free/reduced,1,67,79,84,230
321,female,group E,1,standard,0,75,86,79,240
322,female,group C,2,standard,0,71,81,80,232
323,female,group C,0,free/reduced,0,43,53,53,149
324,female,group C,1,free/reduced,0,41,46,43,130
325,female,group C,2,standard,0,82,90,94,266
326,male,group C,2,standard,0,61,61,62,184
328,male,group C,3,standard,1,82,75,77,234
329,female,group B,0,standard,0,41,55,51,147
330,male,group C,1,standard,0,71,60,61,192
331,male,group C,3,standard,0,47,37,35,119
332,male,group E,3,standard,1,62,56,53,171
333,male,group B,3,standard,0,90,78,81,249
334,female,group C,4,standard,0,83,93,95,271
335,female,group B,2,free/reduced,0,61,68,66,195
336,male,group D,0,standard,1,76,70,69,215
337,male,group C,3,standard,0,49,51,43,143
338,female,group B,0,free/reduced,0,24,38,27,89
339,female,group D,0,free/reduced,1,35,55,60,150
340,male,group C,1,free/reduced,0,58,61,52,171
341,female,group C,1,standard,0,61,73,63,197
342,female,group B,1,standard,1,69,76,74,219
343,male,group D,3,standard,1,67,72,67,206
344,male,group D,2,standard,0,79,73,67,219
345,female,group C,1,standard,0,72,80,75,227
346,male,group B,2,standard,0,62,61,57,180
347,female,group C,4,standard,1,77,94,95,266
348,male,group D,1,free/reduced,0,75,74,66,215
349,male,group E,3,standard,0,87,74,76,237
350,female,group B,4,standard,0,52,65,69,186
351,male,group E,2,standard,0,66,57,52,175
352,female,group C,2,standard,1,63,78,80,221
353,female,group C,3,standard,0,46,58,57,161
354,female,group C,2,standard,0,59,71,70,200
355,female,group B,4,standard,0,61,72,70,203
356,male,group A,3,standard,0,63,61,61,185
357,female,group C,2,free/reduced,1,42,66,69,177
358,male,group D,2,free/reduced,0,59,62,61,182
359,female,group D,2,standard,0,80,90,89,259
360,female,group B,1,standard,0,58,62,59,179
361,male,group B,0,standard,1,85,84,78,247
362,female,group C,2,standard,0,52,58,58,168
363,female,group D,0,free/reduced,0,27,34,32,93
364,male,group C,2,standard,0,59,60,58,177
365,male,group A,4,free/reduced,1,49,58,60,167
366,male,group C,1,standard,1,69,58,53,180
367,male,group C,4,free/reduced,0,61,66,61,188
368,female,group A,0,free/reduced,0,44,64,58,166
369,female,group D,0,standard,0,73,84,85,242
370,male,group E,2,standard,0,84,77,71,232
371,female,group C,2,free/reduced,1,45,73,70,188
372,male,group D,0,standard,0,74,74,72,220
373,female,group D,2,standard,1,82,97,96,275
374,female,group D,4,standard,0,59,70,73,202
375,male,group E,3,free/reduced,0,46,43,41,130
376,female,group D,0,standard,0,80,90,82,252
377,female,group D,5,free/reduced,1,85,95,100,280
378,female,group A,0,standard,0,71,83,77,231
379,male,group A,4,standard,0,66,64,62,192
380,female,group B,3,standard,0,80,86,83,249
381,male,group C,3,standard,1,87,100,95,282
382,male,group C,5,free/reduced,0,79,81,71,231
383,female,group E,0,free/reduced,0,38,49,45,132
384,female,group A,0,free/reduced,0,38,43,43,124
385,female,group E,2,standard,0,67,76,75,218
386,female,group E,4,standard,0,64,73,70,207
387,female,group C,3,free/reduced,0,57,78,67,202
388,female,group D,1,standard,0,62,64,64,190
389,male,group D,5,standard,0,73,70,75,218
390,male,group E,0,free/reduced,1,73,67,59,199
391,female,group D,2,standard,0,77,68,77,222
392,male,group E,2,standard,0,76,67,67,210
393,male,group C,3,standard,1,57,54,56,167
394,female,group C,0,standard,1,65,74,77,216
395,male,group A,1,free/reduced,0,48,45,41,134
396,female,group B,1,free/reduced,0,50,67,63,180
397,female,group C,3,standard,0,85,89,95,269
398,male,group B,0,standard,0,74,63,57,194
399,male,group D,0,standard,0,60,59,54,173
400,female,group C,0,standard,1,59,54,67,180
401,male,group A,2,standard,0,53,43,43,139
402,female,group A,2,free/reduced,0,49,65,55,169
403,female,group D,1,standard,1,88,99,100,287
404,female,group C,1,standard,0,54,59,62,175
405,female,group C,0,standard,0,63,73,68,204
406,male,group B,3,standard,1,65,65,63,193
407,female,group B,3,standard,0,82,80,77,239
408,female,group D,1,free/reduced,1,52,57,56,165
409,male,group D,3,standard,1,87,84,85,256
410,female,group D,5,standard,1,70,71,74,215
411,male,group E,2,standard,1,84,83,78,245
412,male,group D,3,standard,0,71,66,60,197
413,male,group B,0,standard,1,63,67,67,197
414,female,group C,4,free/reduced,1,51,72,79,202
415,male,group E,1,standard,0,84,73,69,226
416,male,group C,4,standard,1,71,74,68,213
417,male,group C,3,standard,0,74,73,67,214
418,male,group D,2,standard,0,68,59,62,189
419,male,group E,1,free/reduced,1,57,56,54,167
420,female,group C,3,free/reduced,1,82,93,93,268
421,female,group D,1,standard,1,57,58,64,179
422,female,group D,5,free/reduced,1,47,58,67,172
423,female,group A,0,standard,1,59,85,80,224
424,male,group B,2,free/reduced,0,41,39,34,114
425,female,group C,2,free/reduced,0,62,67,62,191
426,male,group C,4,standard,0,86,83,86,255
427,male,group C,0,free/reduced,0,69,71,65,205
428,male,group A,0,free/reduced,0,65,59,53,177
429,male,group C,0,free/reduced,0,68,63,54,185
430,male,group C,3,free/reduced,0,64,66,59,189
431,female,group C,1,standard,0,61,72,70,203
432,male,group C,1,standard,0,61,56,55,172
433,female,group A,0,free/reduced,0,47,59,50,156
434,male,group C,0,standard,0,73,66,66,205
435,male,group C,2,free/reduced,1,50,48,53,151
436,male,group D,3,standard,0,75,68,64,207
437,male,group D,3,free/reduced,0,75,66,73,214
438,male,group C,1,standard,0,70,56,51,177
439,male,group D,0,standard,1,89,88,82,259
440,female,group C,2,standard,1,67,81,79,227
441,female,group D,1,standard,0,78,81,80,239
442,female,group A,0,free/reduced,0,59,73,69,201
443,female,group B,3,standard,0,73,83,76,232
444,male,group A,0,free/reduced,0,79,82,73,234
445,female,group C,0,standard,1,67,74,77,218
446,male,group D,2,free/reduced,0,69,66,60,195
447,male,group C,1,standard,1,86,81,80,247
448,male,group B,1,standard,0,47,46,42,135
449,male,group B,3,standard,0,81,73,72,226
450,female,group C,2,free/reduced,1,64,85,85,234
451,female,group E,2,standard,0,100,92,97,289
452,female,group C,3,free/reduced,0,65,77,74,216
453,male,group C,2,free/reduced,0,65,58,49,172
454,female,group C,3,free/reduced,0,53,61,62,176
455,male,group C,4,free/reduced,0,37,56,47,140
456,female,group D,4,standard,0,79,89,89,257
457,male,group D,3,free/reduced,0,53,54,48,155
458,female,group E,4,standard,0,100,100,100,300
459,male,group B,1,standard,1,72,65,68,205
460,male,group C,4,free/reduced,0,53,58,55,166
461,male,group B,2,free/reduced,0,54,54,45,153
462,female,group E,2,standard,0,71,70,76,217
463,female,group C,2,free/reduced,0,77,90,91,258
464,male,group A,4,standard,1,75,58,62,195
465,female,group C,2,standard,0,84,87,91,262
466,female,group D,3,free/reduced,0,26,31,38,95
467,male,group A,1,free/reduced,1,72,67,65,204
468,female,group A,1,free/reduced,1,77,88,85,250
469,male,group C,2,standard,0,91,74,76,241
470,female,group C,3,standard,1,83,85,90,258
471,female,group C,1,standard,0,63,69,74,206
472,female,group C,3,standard,1,68,86,84,238
473,female,group D,0,standard,0,59,67,61,187
474,female,group B,3,standard,1,90,90,91,271
475,female,group D,4,standard,1,71,76,83,230
476,male,group E,4,standard,1,76,62,66,204
477,male,group D,3,standard,0,80,68,72,220
478,female,group D,5,standard,0,55,64,70,189
479,male,group E,3,standard,0,76,71,67,214
480,male,group B,1,standard,1,73,71,68,212
481,female,group D,3,free/reduced,0,52,59,56,167
482,male,group C,2,free/reduced,0,68,68,61,197
483,male,group A,1,standard,0,59,52,46,157
484,female,group B,3,standard,0,49,52,54,155
485,male,group C,1,standard,0,70,74,71,215
486,male,group D,2,free/reduced,0,61,47,56,164
487,female,group C,3,free/reduced,0,60,75,74,209
488,male,group B,0,standard,1,64,53,57,174
489,male,group A,3,free/reduced,1,79,82,82,243
490,female,group A,3,free/reduced,0,65,85,76,226
491,female,group C,3,standard,0,64,64,70,198
492,female,group C,2,standard,0,83,83,90,256
493,female,group C,4,standard,0,81,88,90,259
494,female,group B,1,standard,0,54,64,68,186
495,male,group D,1,standard,1,68,64,66,198
496,female,group C,2,standard,0,54,48,52,154
497,female,group D,2,free/reduced,1,59,78,76,213
498,female,group B,0,standard,0,66,69,68,203
499,male,group E,2,standard,0,76,71,72,219
500,female,group D,5,standard,0,74,79,82,235
501,female,group B,3,standard,1,94,87,92,273
502,male,group C,2,free/reduced,0,63,61,54,178
503,female,group E,3,standard,1,95,89,92,276
504,female,group D,5,free/reduced,0,40,59,54,153
505,female,group B,0,standard,0,82,82,80,244
506,male,group A,1,standard,0,68,70,66,204
507,male,group B,4,free/reduced,0,55,59,54,168
508,male,group C,5,standard,0,79,78,77,234
509,female,group C,4,standard,0,86,92,87,265
510,male,group D,2,standard,0,76,71,73,220
511,male,group A,0,standard,0,64,50,43,157
512,male,group D,0,free/reduced,0,62,49,52,163
513,female,group B,0,standard,1,54,61,62,177
514,female,group B,5,free/reduced,1,77,97,94,268
515,female,group C,0,standard,1,76,87,85,248
516,female,group D,2,standard,0,74,89,84,247
517,female,group E,2,standard,1,66,74,73,213
518,female,group D,0,standard,1,66,78,78,222
519,female,group B,1,free/reduced,1,67,78,79,224
520,male,group D,2,standard,0,71,49,52,172
521,female,group C,3,standard,0,91,86,84,261
522,male,group D,4,standard,0,69,58,57,184
523,male,group C,5,free/reduced,0,54,59,50,163
524,male,group C,1,standard,1,53,52,49,154
525,male,group E,2,standard,0,68,60,59,187
526,male,group C,0,free/reduced,1,56,61,60,177
527,female,group C,1,free/reduced,0,36,53,43,132
528,female,group D,4,free/reduced,0,29,41,47,117
529,female,group C,3,standard,0,62,74,70,206
530,female,group C,3,standard,1,68,67,73,208
531,female,group C,0,standard,0,47,54,53,154
532,male,group E,3,standard,1,62,61,58,181
533,female,group E,3,standard,1,79,88,94,261
534,male,group B,1,standard,1,73,69,68,210
535,female,group C,4,free/reduced,1,66,83,83,232
536,male,group C,3,standard,1,51,60,58,169
537,female,group D,1,standard,0,51,66,62,179
538,male,group E,4,standard,1,85,66,71,222
539,male,group A,3,standard,1,97,92,86,275
540,male,group C,1,standard,1,75,69,68,212
541,male,group D,3,free/reduced,1,79,82,80,241
542,female,group C,3,standard,0,81,77,79,237
543,female,group D,3,standard,0,82,95,89,266
544,female,group D,5,standard,0,64,63,66,193
545,male,group E,0,free/reduced,1,78,83,80,241
546,female,group A,0,standard,1,92,100,97,289
547,male,group C,1,standard,1,72,67,64,203
548,female,group C,1,free/reduced,0,62,67,64,193
549,male,group C,5,standard,0,79,72,69,220
550,male,group C,0,free/reduced,0,79,76,65,220
551,male,group B,4,free/reduced,1,87,90,88,265
552,female,group B,3,standard,0,40,48,50,138
553,male,group D,2,free/reduced,0,77,62,64,203
554,male,group E,3,standard,0,53,45,40,138
555,female,group C,2,free/reduced,0,32,39,33,104
556,female,group C,3,standard,1,55,72,79,206
557,male,group C,5,free/reduced,0,61,67,66,194
558,female,group B,3,free/reduced,0,53,70,70,193
559,male,group D,0,standard,0,73,66,62,201
560,female,group D,2,standard,1,74,75,79,228
561,female,group C,2,standard,0,63,74,74,211
562,male,group C,4,standard,1,96,90,92,278
563,female,group D,2,free/reduced,1,63,80,80,223
564,male,group B,4,free/reduced,0,48,51,46,145
565,male,group B,3,standard,0,48,43,45,136
566,female,group E,4,free/reduced,1,92,100,100,292
567,female,group D,5,free/reduced,1,61,71,78,210
568,male,group B,1,free/reduced,0,63,48,47,158
569,male,group D,4,free/reduced,0,68,68,67,203
570,male,group B,2,standard,1,71,75,70,216
571,male,group A,4,standard,0,91,96,92,279
572,female,group C,2,standard,0,53,62,56,171
573,female,group C,1,free/reduced,1,50,66,64,180
574,female,group E,1,standard,0,74,81,71,226
575,male,group A,3,free/reduced,1,40,55,53,148
576,male,group A,2,standard,1,61,51,52,164
577,female,group B,1,standard,0,81,91,89,261
578,female,group B,2,free/reduced,1,48,56,58,162
579,female,group D,5,standard,0,53,61,68,182
580,female,group D,0,standard,0,81,97,96,274
581,female,group E,0,standard,0,77,79,80,236
582,female,group D,4,free/reduced,0,63,73,78,214
583,female,group D,3,standard,1,73,75,80,228
584,female,group D,2,standard,0,69,77,77,223
585,female,group C,3,standard,0,65,76,76,217
586,female,group A,1,standard,0,55,73,73,201
587,female,group C,4,free/reduced,0,44,63,62,169
588,female,group C,2,standard,0,54,64,65,183
589,female,group A,0,standard,0,48,66,65,179
590,male,group C,2,free/reduced,0,58,57,54,169
591,male,group A,0,standard,0,71,62,50,183
592,male,group E,4,standard,0,68,68,64,200
593,female,group E,1,standard,0,74,76,73,223
594,female,group C,4,standard,1,92,100,99,291
595,female,group C,4,standard,1,56,79,72,207
597,male,group A,0,standard,0,53,54,48,155
598,female,group D,1,standard,0,69,77,73,219
599,female,group D,0,standard,0,65,82,81,228
600,female,group D,5,standard,0,54,60,63,177
601,female,group C,1,standard,0,29,29,30,88
602,female,group E,2,standard,0,76,78,80,234
603,male,group D,1,free/reduced,0,60,57,51,168
604,male,group D,5,free/reduced,1,84,89,90,263
605,male,group C,0,standard,0,75,72,62,209
606,female,group C,3,standard,0,85,84,82,251
607,female,group C,5,free/reduced,0,40,58,54,152
608,female,group E,2,standard,0,61,64,62,187
609,female,group B,3,standard,0,58,63,65,186
610,male,group D,2,free/reduced,1,69,60,63,192
611,female,group C,2,standard,0,58,59,66,183
612,male,group C,4,standard,1,94,90,91,275
613,female,group C,3,standard,0,65,77,74,216
614,female,group A,3,standard,0,82,93,93,268
615,female,group C,1,standard,0,60,68,72,200
616,female,group E,4,standard,0,37,45,38,120
617,male,group D,4,standard,0,88,78,83,249
618,male,group D,5,standard,0,95,81,84,260
619,male,group C,3,free/reduced,1,65,73,68,206
620,female,group C,1,free/reduced,0,35,61,54,150
621,male,group B,4,free/reduced,0,62,63,56,181
622,male,group C,1,free/reduced,1,58,51,52,161
623,male,group A,2,standard,1,100,96,86,282
624,female,group E,4,free/reduced,0,61,58,62,181
625,male,group D,2,standard,1,100,97,99,296
626,male,group B,3,free/reduced,1,69,70,63,202
627,male,group D,3,standard,0,61,48,46,155
628,male,group D,2,free/reduced,0,49,57,46,152
629,female,group C,0,standard,1,44,51,55,150
630,male,group D,2,standard,0,67,64,70,201
631,male,group B,1,standard,0,79,60,65,204
632,female,group B,4,standard,1,66,74,81,221
633,female,group C,1,standard,0,75,88,85,248
634,male,group D,0,standard,0,84,84,80,248
635,male,group A,1,standard,0,71,74,64,209
636,female,group B,1,free/reduced,1,67,80,81,228
637,female,group D,0,standard,1,80,92,88,260
638,male,group E,2,standard,0,86,76,74,236
639,female,group D,3,standard,0,76,74,73,223
640,male,group D,1,standard,0,41,52,51,144
641,female,group D,3,free/reduced,1,74,88,90,252
642,female,group B,0,free/reduced,0,72,81,79,232
643,female,group E,1,standard,1,74,79,80,233
644,male,group B,1,standard,0,70,65,60,195
645,female,group B,4,standard,1,65,81,81,227
646,female,group D,3,standard,0,59,70,65,194
647,female,group E,1,free/reduced,0,64,62,68,194
648,female,group B,1,standard,0,50,53,55,158
649,female,group D,2,standard,1,69,79,81,229
650,male,group C,0,free/reduced,1,51,56,53,160
651,female,group A,1,standard,1,68,80,76,224
652,female,group D,2,standard,1,85,86,98,269
653,female,group A,3,standard,1,65,70,74,209
654,female,group B,0,standard,0,73,79,79,231
655,female,group B,2,standard,0,62,67,67,196
656,male,group C,3,free/reduced,0,77,67,64,208
657,male,group D,0,standard,0,69,66,61,196
658,female,group D,3,free/reduced,0,43,60,58,161
659,male,group D,3,standard,0,90,87,85,262
660,male,group C,2,free/reduced,0,74,77,73,224
661,male,group C,0,standard,0,73,66,63,202
662,female,group D,2,free/reduced,0,55,71,69,195
663,female,group C,1,standard,0,65,69,67,201
664,male,group D,3,standard,0,80,63,63,206
665,female,group C,0,free/reduced,1,50,60,60,170
666,female,group C,2,free/reduced,1,63,73,71,207
667,female,group B,4,free/reduced,0,77,85,87,249
668,male,group C,2,standard,0,73,74,61,208
669,male,group D,3,standard,1,81,72,77,230
670,female,group C,1,free/reduced,0,66,76,68,210
671,male,group D,3,free/reduced,0,52,57,50,159
672,female,group C,2,standard,0,69,78,76,223
673,female,group C,3,standard,1,65,84,84,233
674,female,group D,1,standard,1,69,77,78,224
675,female,group B,2,standard,1,50,64,66,180
676,female,group E,2,standard,1,73,78,76,227
677,female,group C,0,standard,1,70,82,76,228
678,male,group D,3,free/reduced,0,81,75,78,234
679,male,group D,2,free/reduced,0,63,61,60,184
680,female,group D,1,standard,0,67,72,74,213
681,male,group B,1,standard,0,60,68,60,188
682,male,group B,1,standard,0,62,55,54,171
683,female,group C,0,free/reduced,1,29,40,44,113
684,male,group B,2,standard,1,62,66,68,196
685,female,group E,5,standard,1,94,99,100,293
686,male,group E,2,standard,1,85,75,68,228
687,male,group D,3,free/reduced,0,77,78,73,228
688,male,group A,1,free/reduced,0,53,58,44,155
689,male,group E,2,free/reduced,0,93,90,83,266
690,female,group C,3,standard,0,49,53,53,155
691,female,group E,3,free/reduced,0,73,76,78,227
692,female,group C,4,free/reduced,1,66,74,81,221
693,female,group D,3,standard,0,77,77,73,227
694,female,group C,0,standard,0,49,63,56,168
695,female,group D,2,free/reduced,0,79,89,86,254
696,female,group C,3,standard,1,75,82,90,247
697,female,group A,4,standard,0,59,72,70,201
698,female,group D,3,standard,1,57,78,79,214
699,male,group C,1,free/reduced,0,66,66,59,191
700,female,group E,4,standard,1,79,81,82,242
701,female,group B,0,standard,0,57,67,72,196
702,male,group A,4,standard,1,87,84,87,258
703,female,group D,2,standard,0,63,64,67,194
704,female,group B,0,free/reduced,1,59,63,64,186
705,male,group A,4,free/reduced,0,62,72,65,199
706,male,group D,1,standard,0,46,34,36,116
707,male,group C,2,standard,0,66,59,52,177
708,male,group D,1,standard,0,89,87,79,255
709,female,group D,3,free/reduced,1,42,61,58,161
710,male,group C,2,standard,1,93,84,90,267
711,female,group E,0,standard,1,80,85,85,250
712,female,group D,2,standard,0,98,100,99,297
713,male,group D,5,standard,0,81,81,84,246
714,female,group B,0,standard,1,60,70,74,204
715,female,group B,3,free/reduced,1,76,94,87,257
716,male,group C,3,standard,1,73,78,72,223
717,female,group C,3,standard,1,96,96,99,291
718,female,group C,1,standard,0,76,76,74,226
719,male,group E,3,free/reduced,1,91,73,80,244
720,female,group C,2,free/reduced,0,62,72,70,204
721,male,group D,0,free/reduced,1,55,59,59,173
722,female,group B,0,free/reduced,1,74,90,88,252
723,male,group C,1,standard,0,50,48,42,140
724,male,group B,2,standard,0,47,43,41,131
725,male,group E,2,standard,1,81,74,71,226
726,female,group E,3,standard,1,65,75,77,217
727,male,group E,0,standard,1,68,51,57,176
728,female,group D,1,free/reduced,0,73,92,84,249
729,male,group C,2,standard,0,53,39,37,129
730,female,group B,3,free/reduced,1,68,77,80,225
731,male,group A,0,free/reduced,0,55,46,43,144
732,female,group C,2,standard,1,87,89,94,270
733,male,group D,0,standard,0,55,47,44,146
734,female,group E,2,free/reduced,0,53,58,57,168
735,male,group C,5,standard,0,67,57,59,183
736,male,group C,3,standard,0,92,79,84,255
737,female,group B,2,free/reduced,1,53,66,73,192
738,male,group D,3,standard,0,81,71,73,225
739,male,group C,1,free/reduced,0,61,60,55,176
740,male,group D,4,standard,0,80,73,72,225
741,female,group A,3,free/reduced,0,37,57,56,150
742,female,group C,1,standard,0,81,84,82,247
743,female,group C,3,standard,1,59,73,72,204
744,male,group B,2,free/reduced,0,55,55,47,157
745,male,group D,3,standard,0,72,79,74,225
746,male,group D,1,standard,0,69,75,71,215
747,male,group C,2,standard,0,69,64,68,201
748,female,group C,4,free/reduced,0,50,60,59,169
749,male,group B,2,standard,1,87,84,86,257
750,male,group D,0,standard,1,71,69,68,208
751,male,group E,2,standard,0,68,72,65,205
752,male,group C,5,free/reduced,1,79,77,75,231
753,female,group C,0,standard,1,77,90,85,252
754,male,group C,3,free/reduced,0,58,55,53,166
755,female,group E,3,standard,0,84,95,92,271
756,male,group D,2,standard,0,55,58,52,165
757,male,group E,4,free/reduced,1,70,68,72,210
758,female,group D,2,free/reduced,1,52,59,65,176
759,male,group B,2,standard,1,69,77,77,223
760,female,group C,1,free/reduced,0,53,72,64,189
761,female,group D,0,standard,0,48,58,54,160
762,male,group D,0,standard,1,78,81,86,245
763,female,group B,1,standard,0,62,62,63,187
764,male,group D,2,standard,0,60,63,59,182
765,female,group B,1,standard,0,74,72,72,218
766,female,group C,1,standard,1,58,75,77,210
767,male,group B,1,standard,1,76,62,60,198
768,female,group D,0,standard,0,68,71,75,214
769,male,group A,2,free/reduced,0,58,60,57,175
770,male,group B,1,standard,0,52,48,49,149
771,male,group D,4,standard,0,75,73,74,222
772,female,group B,0,free/reduced,1,52,67,72,191
773,female,group C,4,free/reduced,0,62,78,79,219
774,male,group B,2,standard,0,66,65,60,191
775,female,group B,0,free/reduced,0,49,58,55,162
776,female,group B,1,standard,0,66,72,70,208
777,female,group C,2,free/reduced,0,35,44,43,122
778,female,group A,2,standard,1,72,79,82,233
779,male,group E,3,standard,1,94,85,82,261
780,female,group D,3,free/reduced,0,46,56,57,159
781,female,group B,5,standard,0,77,90,84,251
782,female,group B,1,free/reduced,1,76,85,82,243
783,female,group C,3,standard,1,52,59,62,173
784,male,group C,4,standard,1,91,81,79,251
785,female,group B,0,standard,1,32,51,44,127
786,female,group E,0,free/reduced,0,72,79,77,228
788,male,group C,3,free/reduced,0,68,65,61,194
789,female,group C,5,free/reduced,0,52,65,61,178
790,female,group B,1,standard,0,48,62,60,170
791,female,group D,2,free/reduced,0,60,66,70,196
792,male,group D,1,free/reduced,0,66,74,69,209
793,male,group E,0,standard,1,89,84,77,250
794,female,group B,1,standard,0,42,52,51,145
795,female,group E,3,free/reduced,1,57,68,73,198
796,male,group D,1,standard,0,70,70,70,210
797,female,group E,3,free/reduced,0,70,84,81,235
798,male,group E,2,standard,0,69,60,54,183
799,female,group C,3,standard,0,52,55,57,164
800,male,group C,0,standard,1,67,73,68,208
801,male,group C,0,standard,1,76,80,73,229
802,female,group E,3,standard,0,87,94,95,276
803,female,group B,2,standard,0,82,85,87,254
804,female,group C,2,standard,0,73,76,78,227
805,male,group A,2,free/reduced,0,75,81,74,230
806,female,group D,2,free/reduced,0,64,74,75,213
807,female,group E,1,free/reduced,0,41,45,40,126
808,male,group C,1,standard,0,90,75,69,234
809,male,group B,4,standard,0,59,54,51,164
810,male,group A,0,standard,0,51,31,36,118
811,male,group A,1,free/reduced,0,45,47,49,141
812,female,group C,5,standard,1,54,64,67,185
813,male,group E,0,standard,1,87,84,76,247
814,female,group C,1,standard,0,72,80,83,235
815,male,group B,0,standard,1,94,86,87,267
816,female,group A,4,standard,0,45,59,64,168
817,male,group D,4,free/reduced,1,61,70,76,207
818,female,group B,1,free/reduced,0,60,72,68,200
819,female,group C,0,standard,0,77,91,88,256
820,female,group A,0,standard,1,85,90,92,267
821,female,group D,4,free/reduced,0,78,90,93,261
822,male,group E,2,free/reduced,1,49,52,51,152
823,female,group B,1,free/reduced,0,71,87,82,240
824,female,group C,0,free/reduced,0,48,58,52,158
825,male,group C,1,standard,0,62,67,58,187
826,female,group C,3,free/reduced,1,56,68,70,194
827,female,group C,0,standard,0,65,69,76,210
828,female,group D,0,free/reduced,1,69,86,81,236
829,male,group B,0,standard,0,68,54,53,175
830,female,group A,2,free/reduced,0,61,60,57,178
831,female,group C,4,free/reduced,1,74,86,89,249
832,male,group A,4,standard,0,64,60,58,182
833,female,group B,1,standard,1,77,82,89,248
834,male,group B,2,standard,0,58,50,45,153
835,female,group C,1,standard,1,60,64,74,198
836,male,group E,1,standard,0,73,64,57,194
837,female,group A,1,standard,1,75,82,79,236
838,male,group B,3,free/reduced,1,58,57,53,168
839,female,group C,3,standard,0,66,77,73,216
840,female,group D,1,free/reduced,0,39,52,46,137
841,male,group C,0,standard,0,64,58,51,173
842,female,group B,1,free/reduced,1,23,44,36,103
843,male,group B,2,free/reduced,1,74,77,76,227
844,female,group D,0,free/reduced,1,40,65,64,169
845,male,group E,5,standard,0,90,85,84,259
846,male,group C,5,standard,1,91,85,85,261
847,male,group D,1,standard,0,64,54,50,168
848,female,group C,1,standard,0,59,72,68,199
849,male,group D,3,standard,0,80,75,69,224
850,male,group C,5,standard,0,71,67,67,205
851,female,group A,1,standard,0,61,68,63,192
852,female,group E,2,standard,0,87,85,93,265
853,male,group E,0,standard,0,82,67,61,210
854,male,group C,0,standard,0,62,64,55,181
855,female,group B,4,standard,0,97,97,96,290
856,male,group B,2,free/reduced,0,75,68,65,208
857,female,group C,4,standard,0,65,79,81,225
858,male,group B,1,standard,1,52,49,46,147
859,male,group C,3,free/reduced,0,87,73,72,232
860,female,group C,3,standard,0,53,62,53,168
861,female,group E,5,free/reduced,0,81,86,87,254
862,male,group D,4,free/reduced,1,39,42,38,119
863,female,group C,2,standard,1,71,71,80,222
864,male,group C,3,standard,0,97,93,91,281
865,male,group D,2,standard,1,82,82,88,252
866,male,group C,1,free/reduced,0,59,53,52,164
867,male,group B,3,standard,0,61,42,41,144
868,male,group E,3,free/reduced,1,78,74,72,224
869,male,group C,3,free/reduced,0,49,51,51,151
870,male,group B,1,standard,0,59,58,47,164
871,female,group C,2,standard,1,70,72,76,218
872,male,group B,3,standard,1,82,84,78,244
873,male,group E,3,free/reduced,0,90,90,82,262
874,female,group C,4,free/reduced,0,43,62,61,166
875,male,group C,2,free/reduced,0,80,64,66,210
876,male,group D,2,standard,0,81,82,84,247
877,male,group C,0,standard,0,57,61,54,172
878,female,group D,0,standard,0,59,72,80,211
879,female,group D,3,standard,0,64,76,74,214
880,male,group C,4,standard,1,63,64,66,193
881,female,group E,4,standard,1,71,70,70,211
882,female,group B,1,free/reduced,0,64,73,71,208
883,male,group D,4,free/reduced,0,55,46,44,145
884,female,group E,3,standard,0,51,51,54,156
885,female,group C,3,standard,1,62,76,80,218
886,female,group E,3,standard,1,93,100,95,288
887,male,group C,1,free/reduced,0,54,72,59,185
888,female,group D,2,free/reduced,0,69,65,74,208
889,male,group D,1,free/reduced,0,44,51,48,143
890,female,group E,2,standard,1,86,85,91,262
891,female,group E,3,standard,0,85,92,85,262
892,female,group A,5,free/reduced,0,50,67,73,190
893,male,group D,0,standard,1,88,74,75,237
894,female,group E,3,standard,0,59,62,69,190
895,female,group E,0,free/reduced,0,32,34,38,104
896,male,group B,1,free/reduced,0,36,29,27,92
897,female,group B,0,free/reduced,1,63,78,79,220
898,male,group D,3,standard,1,67,54,63,184
899,female,group D,0,standard,1,65,78,82,225
900,male,group D,5,standard,0,85,84,89,258
901,female,group C,5,standard,0,73,78,74,225
902,female,group A,1,free/reduced,1,34,48,41,123
903,female,group D,4,free/reduced,1,93,100,100,293
904,female,group D,0,free/reduced,0,67,84,84,235
905,male,group D,2,standard,0,88,77,77,242
906,male,group B,1,standard,0,57,48,51,156
907,female,group D,2,standard,1,79,84,91,254
908,female,group C,4,free/reduced,0,67,75,72,214
909,male,group E,4,standard,1,70,64,70,204
910,male,group D,4,free/reduced,0,50,42,48,140
911,female,group A,2,standard,0,69,84,82,235
912,female,group C,4,standard,1,52,61,66,179
913,female,group C,4,free/reduced,1,47,62,66,175
914,female,group B,3,free/reduced,0,46,61,55,162
915,female,group E,2,standard,0,68,70,66,204
916,male,group E,4,standard,1,100,100,100,300
917,female,group C,1,standard,0,44,61,52,157
918,female,group C,3,standard,1,57,77,80,214
919,male,group B,2,standard,1,91,96,91,278
920,male,group D,1,free/reduced,0,69,70,67,206
921,female,group C,1,free/reduced,0,35,53,46,134
922,male,group D,1,standard,0,72,66,66,204
923,female,group B,3,free/reduced,0,54,65,65,184
924,male,group D,1,free/reduced,0,74,70,69,213
925,male,group E,0,standard,1,74,64,60,198
926,male,group E,3,free/reduced,0,64,56,52,172
927,female,group D,1,free/reduced,1,65,61,71,197
928,male,group E,3,free/reduced,1,46,43,44,133
929,female,group C,0,free/reduced,0,48,56,51,155
930,male,group C,2,free/reduced,1,67,74,70,211
931,male,group D,2,free/reduced,0,62,57,62,181
932,male,group D,3,free/reduced,1,61,71,73,205
933,male,group C,4,free/reduced,1,70,75,74,219
934,male,group C,3,standard,1,98,87,90,275
935,male,group D,2,free/reduced,0,70,63,58,191
936,male,group A,3,standard,0,67,57,53,177
937,female,group E,1,free/reduced,0,57,58,57,172
938,male,group D,2,standard,1,85,81,85,251
939,male,group D,0,standard,1,77,68,69,214
940,male,group C,5,free/reduced,1,72,66,72,210
941,female,group D,5,standard,0,78,91,96,265
942,male,group C,1,standard,0,81,66,64,211
943,male,group A,0,free/reduced,1,61,62,61,184
944,female,group B,1,standard,0,58,68,61,187
945,female,group C,3,standard,0,54,61,58,173
946,male,group B,1,standard,0,82,82,80,244
947,female,group D,2,free/reduced,0,49,58,60,167
948,male,group B,0,free/reduced,1,49,50,52,151
949,female,group E,1,free/reduced,1,57,75,73,205
950,male,group E,1,standard,0,94,73,71,238
951,female,group D,2,standard,1,75,77,83,235
952,female,group E,0,free/reduced,0,74,74,72,220
953,male,group C,1,standard,1,58,52,54,164
954,female,group C,2,standard,0,62,69,69,200
955,male,group E,3,standard,0,72,57,62,191
956,male,group C,2,standard,0,84,87,81,252
957,female,group D,5,standard,0,92,100,100,292
958,female,group D,1,standard,0,45,63,59,167
959,male,group C,1,standard,0,75,81,71,227
960,female,group A,2,standard,0,56,58,64,178
961,female,group D,0,free/reduced,0,48,54,53,155
962,female,group E,3,standard,0,100,100,100,300
963,female,group C,0,free/reduced,1,65,76,75,216
964,male,group D,2,standard,0,72,57,58,187
965,female,group D,2,standard,0,62,70,72,204
966,male,group A,0,standard,1,66,68,64,198
967,male,group C,2,standard,0,63,63,60,186
968,female,group E,3,standard,0,68,76,67,211
969,female,group B,4,standard,0,75,84,80,239
970,female,group D,4,standard,0,89,100,100,289
971,male,group C,0,standard,1,78,72,69,219
972,female,group A,1,free/reduced,1,53,50,60,163
973,female,group D,2,free/reduced,0,49,65,61,175
974,female,group A,2,standard,0,54,63,67,184
975,female,group C,2,standard,1,64,82,77,223
976,male,group B,2,free/reduced,1,60,62,60,182
977,male,group C,3,standard,0,62,65,58,185
978,male,group D,1,standard,1,55,41,48,144
979,female,group C,3,standard,0,91,95,94,280
981,male,group D,0,standard,0,81,78,78,237
982,male,group B,0,standard,1,79,85,86,250
983,female,group A,2,standard,1,78,87,91,256
984,female,group C,0,standard,0,74,75,82,231
985,male,group A,1,standard,0,57,51,54,162
986,female,group C,3,standard,0,40,59,51,150
987,male,group E,0,standard,1,81,75,76,232
988,female,group A,0,free/reduced,0,44,45,45,134
989,female,group D,2,free/reduced,1,67,86,83,236
990,male,group E,1,free/reduced,1,86,81,75,242
991,female,group B,0,standard,1,65,82,78,225
992,female,group D,3,free/reduced,0,55,76,76,207
993,female,group D,4,free/reduced,0,62,72,74,208
994,male,group A,1,standard,0,63,63,62,188
995,female,group E,5,standard,1,88,99,95,282
996,male,group C,1,free/reduced,0,62,55,55,172
997,female,group C,1,free/reduced,1,59,71,65,195
998,female,group D,2,standard,1,68,78,77,223
999,female,group D,2,free/reduced,0,77,86,86,249
